| | | |  ||
||||| | |||
||||||  | |
| |||| ||||
|   | || ||
||   |    |
|| ||  |  |
| ||  |   |
| |  ||| ||
|| | |    |