|  |   |  |
|||  | |  |
||| | |||||
||   || | |
|   |||| ||
|  |||  |||
| ||||  ||
||  |  || |
| |   |   |
|      |  |