| | ||   ||
|| || |   |
| || ||| ||
| | |  | ||
|  ||     |
||  |||  ||
|||    | ||
|  || | |||
|  |||  | |
||   |||| |