|        ||
|| |    |||
| ||  | |||
|| |||   ||
|||   |  |!
| ||  || ||
|| ||| | ||
||| |   | |
|||| | |  |
|    |    |