| |    |  |
|| |||   ||
||  ||  |||
| |||     |
|  ||| ||||
||  |    ||
|    | || |
| | |||||||
||  |  | ||
|    |